******************************************************************************************************************************************************
*X*X*XXX*X*XXX*X*XXXXXXX*X*X*XXXXX*X*X*X*XXX*X*XXX*XXXXX*X*XXXXX*X*XXXXXXXXXXX*XXXXXXXXX*X*XXXXXXX*X*X*X*XXXXX*XXXXXXX*XXXXXXX*X*XXX*X*X*X*X*X*X*X*X*X
*X*X***X*X***X*X*******X*X*X*****X*X*X*X***X*X***X*****X*X*****X*X***********X*********X*X*******X*X*X*X*****X*******X*******X*X***X*X*X*X*X*X*X*X*X*X
*X*XXXXX*XXX*XXX*X*X*X*XXX*XXXXXXXXXXXXX*X*X*XXX*XXXXXXX*X*X*X*XXX*X*X*X*XXXXXXX*X*X*XXXXX*XXXXX*X*X*XXXXXXX*X*XXX*X*X*XXXXXXX*X*X*XXXXXXXXXXX*X*XXX*X
*X*****X***X***X*X*X*X***X*************X*X*X***X*******X*X*X*X***X*X*X*X*******X*X*X*****X*****X*X*X*******X*X***X*X*X*******X*X*X***********X*X***X*X
*X*X*XXXXX*X*X*X*X*X*XXX*X*X*XXXXXXX*X*X*XXXXX*X*XXXXX*XXX*X*X*X*X*X*X*XXXXXXX*XXX*XXX*XXX*X*XXX*XXX*XXX*XXXXXXXXXXX*XXX*X*XXXXXXX*X*XXXXX*X*XXXXX*X*X
*X*X*****X*X*X*X*X*X***X*X*X*******X*X*X*****X*X*****X***X*X*X*X*X*X*X*******X***X***X***X*X***X***X***X***********X***X*X*******X*X*****X*X*****X*X*X
*XXX*XXX*XXX*XXX*XXXXX*XXX*X*X*X*XXXXX*X*XXX*XXXXX*XXXXX*XXX*XXX*XXXXXXX*X*XXXXX*X*X*X*XXXXX*X*XXX*X*X*XXXXXXXXX*XXXXXXXXXXXXX*XXXXX*X*XXXXX*X*X*XXX*X
***X***X***X***X*****X***X*X*X*X*****X*X***X*****X*****X***X***X*******X*X*****X*X*X*X*****X*X***X*X*X*********X*************X*****X*X*****X*X*X***X*X
*X*XXXXXXX*X*X*XXX*X*XXXXXXXXXXXXX*XXXXXXXXXXXXXXXXXXXXXXXXXXX*XXX*X*XXXXX*XXXXXXX*X*XXXXX*X*XXXXX*X*X*XXXXX*X*X*X*X*X*XXX*X*XXXXXXXXXXX*XXX*XXXXXXXXX
*X*******X*X*X***X*X*************X*******************************X*X*****X*******X*X*****X*X*****X*X*X*****X*X*X*X*X*X***X*X***********X***X*********X
*XXX*X*XXXXX*X*X*X*X*XXXXXXX*X*XXX*X*X*X*XXXXXXXXXXXXXXXXXXXXXXXXXXX*XXXXXXXXX*X*X*X*XXXXXXX*XXX*XXX*XXXXXXXXXXX*XXX*XXXXXXXXXXXXX*XXX*X*XXXXXXXXXXXXX
***X*X*****X*X*X*X*X*******X*X***X*X*X*X*X*X*X***X***X*X***X*X*****X*********X*X*X*X*******X***X***X***********X***X*************X***X*X*************X
*XXXXXXXXXXXXX*XXXXX*XXXXX*XXX*X*XXX*X*XXXXXXX*X*X*X*X*XXX*X*XXX*XXXXX*XXX*XXXXX*XXX*XXX*X*X*XXXXX*XXXXX*XXX*XXXXX*X*XXXXX*XXXXX*X*X*X*XXXXX*X*XXXXX*X
*************X*****X*****X***X*X***X*X*******X*X*X*X*X***X*X***X*****X***X*****X***X***X*X*X*****X*****X***X*****X*X*****X*****X*X*X*X*****X*X*****X*X
*X*XXX*X*XXXXX*XXX*XXXXX*XXX*XXXXX*X*XXX*XXX*X*X*X*X*X*X*X*X*XXXXX*X*X*XXXXXXXXXXXXXXX*X*X*XXX*XXX*X*XXXXX*X*X*XXXXXXX*X*XXXXX*X*X*XXX*X*X*X*X*XXX*X*X
*X***X*X*****X***X*****X***X*****X*X***X***X*X*X*X*X*X*X*X*X*****X*X*X*X***************X*X***X***X*X*****X*X*X*******X*X*****X*X*X***X*X*X*X*X***X*X*X
*X*XXX*XXXXXXXXXXXXX*X*XXX*X*XXX*XXXXX*X*XXXXXXX*X*X*XXX*XXX*XXX*X*X*XXX*X*XXXXXXX*X*XXXXX*XXX*X*X*XXX*X*X*X*XXXXXXXXX*XXX*X*XXXXXXXXX*XXXXX*XXX*X*XXX
*X***X*************X*X***X*X***X*****X*X*******X*X*X***X***X***X*X*X***X*X*******X*X*********X*X*X***X*X*X*X*********X***X*X*********X*****X***X*X***X
*X*XXXXX*X*X*X*XXXXXXX*XXX*XXXXXXXXX*X*XXX*XXXXX*XXXXXXXXX*X*XXX*X*X*XXX*XXX*X*X*XXX*X*X*X*XXX*X*X*X*XXX*XXXXXXXXX*XXX*XXXXX*X*X*XXX*XXX*X*XXXXX*X*X*X
*X*****X*X*X*X*******X***X*********X*****X*****X*********X*X***X*X*X***X***X*X*X*****X*X*X***X*X*X*X***X*********X***X*****X*X*X***X***X*X*****X*X*X*X
*XXXXX*X*X*X*X*X*XXX*XXXXX*X*XXXXX*XXXXX*XXXXXXXXX*X*XXX*XXX*X*XXX*XXXXX*X*X*XXX*XXXXX*X*X*XXXXX*XXXXXXXXXXXXX*XXXXX*X*XXX*XXX*XXX*X*X*XXXXXXXXXXXXX*X
*****X*X*X*X*X*X***X*****X*X*****X*****X*********X*X***X***X*X***X*****X*X*X***X*****X*X*X*******************X*****X*X***X***X***X*X*X*************X*X
*X*XXX*X*X*XXX*X*XXXXX*X*XXX*X*X*XXXXXXX*XXX*XXXXX*XXXXX*XXXXX*X*XXXXX*X*XXXXXXX*XXXXXXXXX*X*XXX*X*XXXXXXX*XXXXXXXXXXXXXXXXX*XXX*X*X*XXXXX*X*X*XXX*X*X
*X***X*X*X***X*X*****X*X***X*X*X*******X***X*****X*****X*****X*X*****X*X*******X*********X*X***X*X*******X*****************X***X*X*X*****X*X*X***X*X*X
*XXXXX*XXXXXXXXXXXXX*X*XXXXX*XXXXXXX*X*XXXXXXX*XXXXXXX*X*XXXXX*X*X*XXX*X*XXXXX*X*X*XXX*X*XXXXX*XXX*XXXXX*X*X*X*X*X*X*X*XXX*XXX*XXXXXXX*XXXXX*X*XXX*X*X
*****X*************X*X*****X*******X*X*******X*******X*X*****X*X*X***X*X*******X*X***X*X*****X***X*X***X*X*X*X*X*X*X*X***X***X*******X*****X*X***X*X*X
*X*X*X*X*X*XXX*X*X*XXXXXXXXXXX*X*XXX*X*X*X*X*X*X*X*XXXXX*XXX*XXX*X*X*XXXXX*XXXXXXXXXXXXXXXXXXX*XXX*XXX*XXX*X*X*X*X*X*XXX*X*XXXXXXX*X*XXXXX*XXXXX*X*XXX
*X*X*X*X*X***X*X*X***********X*X***X*X*X*X*X*X*X*X*****X***X***X*X*X*****X*******************X***X***X***X*X*X*X*X*X***X*X*******X*X*****X*****X*X***X
*XXX*XXX*XXX*XXX*XXX*XXX*XXX*X*XXXXXXXXX*XXX*XXXXX*X*X*X*XXXXXXXXX*XXXXX*XXXXX*XXX*X*X*XXX*XXXXX*XXX*XXXXXXXXX*XXX*XXX*XXXXX*XXX*XXXXX*XXXXXXXXXXX*X*X
***X***X***X***X***X***X***X*X*********X***X*****X*X*X*X*********X*****X*****X***X*X*X***X****XX***X*********X***X***X*****X***X*****X***********X*X*X
*XXXXXXXXXXXXX*XXX*XXX*XXXXXXXXX*XXXXX*X*X*X*X*XXX*XXXXX*XXXXXXXXXXXXXXXXX*XXX*XXXXXXXXXXXXXXX*X*XXXXXXX*X*X*XXXXX*XXX*X*XXXXX*X*XXXXX*X*XXXXX*XXXXX*X
*************X***X***X*********X*****X*X*X*X*X***X*****X*****************X***X***************X*********X*X*X*****X***X*X*****X*X*****X*X*****X*****X*X
*XXX*X*X*XXX*XXXXX*X*X*X*XXX*X*X*XXXXX*XXX*XXXXXXX*XXX*X*XXX*XXXXXXXXX*XXX*X*XXXXX*XXX*X*X*X*XXXXX*XXX*XXXXX*XXX*X*X*XXX*X*X*X*X*X*X*XXXXXXXXX*X*XXXXX
***X*X*X***X*****X*X*X*X***X*X*X*****X***X*******X***X*X***X*********X***X*X*****X***X*X*X*X*****X***X*X***X***X*X*X***X*X*X*X*X*X*X*********X*X*****X
*XXX*X*X*X*XXX*XXXXX*XXX*XXX*XXX*X*X*XXXXX*X*X*X*X*XXX*XXX*XXX*XXX*XXX*XXX*XXX*X*X*X*XXX*XXX*XXX*XXXXXXX*X*X*XXX*X*XXX*X*XXXXX*X*X*XXXXXXXXX*X*X*XXXXX
***X*X*X*X***X*****X***X***X***X*X*X*****X*X*X*X*X***X***X***X***X***X***X***X*X*X*X***X***X***X*******X*X*****X*X***X*X*****X*X*X*********X*X*X*****X
*XXXXX*X*XXX*X*XXX*X*X*X*XXX*X*X*XXX*XXX*X*X*X*X*X*X*XXXXXXXXXXXXXXX*X*XXX*X*XXXXXXXXX*XXX*X*X*X*XXX*XXX*XXXXXXX*XXXXXXXXXXXXXXX*XXXXX*X*X*XXX*X*XXXXX
*****X*X***X*X***X*X*X*X***X*X*X***X***X*X*X*X*X*X*X***************X*X***X*X*********X***X*X*X*X***X***X*******X***************X*****X*X*X***X*X*****X
*X*X*X*XXXXXXXXXXX*XXX*XXXXX*XXXXX*X*XXX*XXXXX*X*X*XXX*XXX*X*X*XXXXXXX*XXXXX*XXXXX*X*XXX*XXXXX*X*X*XXX*X*XXXXX*XXXXXXXXXXXXX*XXXXXXXXX*XXX*X*XXXXX*XXX
*X*X*X***********X***X*****X*****X*X***X*****X*X*X***X***X*X*X*******X*****X*****X*X***X*****X*X*X***X*X*****X*************XXX*******X***X*X*****X***X
*XXX*X*X*X*XXX*XXXXXXXXX*XXX*X*XXXXX*XXX*XXXXX*X*XXXXXXX*XXX*X*XXX*XXXXXXX*X*XXX*X*XXXXX*XXX*XXXXX*XXX*X*XXXXXXXXXXXXX*XXXXX*X*X*X*X*X*XXXXX*X*XXX*X*X
***X*X*X*X***X*********X***X*X*****X***X*****X*X*******X***X*X***X*******X*X***X*X*****X***X*****X***X*X*************X*****X*X*X*X*X*X*****X*X***X*X*X
*X*X*X*X*X*XXX*XXX*X*XXX*XXXXX*X*X*X*XXXXXXXXX*X*XXX*XXXXX*XXX*X*X*XXXXX*XXXXX*X*X*XXXXX*XXXXX*X*X*X*X*XXXXXXXXXXXXXXXXXXXXX*XXX*XXX*XXXXX*XXXXXXXXXXX
*X*X*X*X*X***X***X*X***X*****X*X*X*X*********X*X***X*****X***X*X*X*****X*****X*X*X*****X*****X*X*X*X***********************X*******X**X**X*X*********X
*XXXXXXX*XXXXXXX*XXXXXXX*XXXXX*XXX*X*X*XXX*X*X*X*XXXXX*XXXXX*XXXXXXX*X*XXX*XXX*X*XXX*XXXXX*XXXXX*X*X*X*XXX*XXXXX*XXX*X*XXX*X*X*X*XXXXX*X*XXXXXXXXXXX*X
*******X*******X*******X*****X***X*X*X***X*X*X*X*****X*****X*******X*X***X***X*X***X*****X*****X*X*X*X***X*****X***X*X***X*X*X*X*****X*X***********X*X
*XXX*X*XXXXXXXXX*X*X*X*X*XXX*XXX*XXX*XXX*XXX*X*X*XXXXXXX*XXXXXXX*X*X*X*XXX*X*X*XXXXX*X*XXXXXXX*XXX*XXX*XXX*X*X*X*X*X*XXX*X*XXXXX*X*XXX*X*X*XXX*XXX*X*X
***X*X*********X*X*X*X*X***X***X***X***X***X*X*X*******X*******X*X*X*X***X*X*X*****X*X*******X***X***X***X*X*X*X*X*X***X*X*******X*******X***X********
XXXXXXXXXXXXXXXXXXXXXXXXXXXXXXXXXXXXXXXXXXXXXXXXXXXXXXXXXXXXXXXXXXXXXXXXXXXXXXXXXXXXXXXXXXXXXXXXXXXXXXXXXXXXXXXXXXXXXXXXXXXXXXXXXXXXXXXXXXXXXXXXXXXXX*